SO textures/round.png
NO textures/blackhole.png
EA textures/stars.png
WE textures/round2.png

C 1, 1, 1
F 1, 1, 1

        1111111111111111111111111
        1000000000110000000000001
        101100000101000000000000111
        100100000000000000000000101
11111111101100000111000000000000111
100000000011000001110111111111111
11110111111111011100000010001
11110111111111011101010010001             111111
11000000110101011100000010001             100S01
10000000000000000110000010111             111111
10000000000000001101010010001
1100000111010101111101111001111111
11110111 1110101 101111110001  111
11111111 1111111 111111111111  111