SO textures/round.png
WE textures/round2.png
NO textures/blackhole.png
EA textures/stars.png

C 226,30,0
F 220,100,0

        1111111111111111111111111
        1000000000110000000000001
        1011000001110000000000001
        1001000000000000000000001
111111111011000001110000000000001
100000000011000001110111111111111
11110111111111011100000010001
11110111111111011101010010001
11000000110101011100000010001
1000000000000000011S000010111
10000000000000001101010010001
1100000111010101111101111001111111
11110111 1110101 101111010001  111
11111111 1111111 111111111111  111